WWWWWWW
W00000W
W00M00W
W0P000W
M000F0W
WWWWWWW
