WWWWWWW
W00000W
W00M00W
W0P000W
W0W0F0W
WWWWWWW
