WWWWWWW
W00000W
W00M00W
W0P000W
WP00F0W
WWWWWWW
