WWWWWWW
W00F00W
W00M00W
W0P000W
W000F0W
WWWWWWW
