WWWWWWW
W00000W
W0FM00W
W0P000W
W000F0W
WWWWWWW
