WWWWWWW
W00000W
W00M00W
W0P0000
W000F0W
WWWWWWW
