WWWWWWW
W00000W
W00M0WW
W0P000W
W000F0W
WWWWWWW
