WWWWWWW
W00000W
000M00W
W0P000W
W000F0W
WWWWWWW
