WWWWWWW
W00000W
W00M00W
W0P000W
W000W0W
WWWWWWW
