WWWWWWW
W00000W
W00M00W
W0P000F
W000F0W
WWWWWWW
