WWWWWWW
W00000W
W00M00W
WMP000W
W000F0W
WWWWWWW
