WWWWWWW
W00000W
M00M00W
W0P000W
W000F0W
WWWWWWW
