WWWWWWW
W00000W
W00M00W
W0P000W
W00MF0W
WWWWWWW
