WWWWWWW
W00000W
W00M00W
W0P00FW
W000F0W
WWWWWWW
