WWWWWWW
W00000W
W0WM00W
W0P000W
W000F0W
WWWWWWW
