WWWWWWW
W00000W
WW0M00W
W0P000W
W000F0W
WWWWWWW
