WWWWWWW
W00000W
W00M00W
W0P0F0W
W000F0W
WWWWWWW
