WWWWWWW
W00000W
W00M00P
W0P000W
W000F0W
WWWWWWW
