WWWWWWW
W00000W
W00M00W
W0P000W
WF00F0W
WWWWWWW
