WWWWWWW
W00000W
W00M00W
W0P000P
W000F0W
WWWWWWW
