WWWWWWW
W00000W
W00MW0W
W0P000W
W000F0W
WWWWWWW
