WWWWWWW
W00000W
W00M00W
WPP000W
W000F0W
WWWWWWW
