WWWWWWW
W00000W
W00F00W
W0P000W
W000F0W
WWWWWWW
