WWWWWWW
W00000W
W00M00W
W0P000W
0000F0W
WWWWWWW
