WWWWWWW
W00000W
WP0M00W
W0P000W
W000F0W
WWWWWWW
