WWWWWWW
W00000W
W00P00W
W0P000W
W000F0W
WWWWWWW
