WWWWWWW
W00000W
W00M00W
W0P000W
F000F0W
WWWWWWW
