WWWWWWW
W00000P
W00M00W
W0P000W
W000F0W
WWWWWWW
