WWWWWWW
W00000W
W00M0PW
W0P000W
W000F0W
WWWWWWW
