WWWWWWW
W00000W
W00M00W
M0P000W
W000F0W
WWWWWWW
