WWWWWWW
W00000W
W00M00W
W0P00MW
W000F0W
WWWWWWW
