WWWWWWW
W00000W
W00M00W
00P000W
W000F0W
WWWWWWW
