WWWWWWW
W00000W
W00M00W
W0P000W
P000F0W
WWWWWWW
