WWWWWWW
W000W0W
W00M00W
W0P000W
W000F0W
WWWWWWW
