WWWWWWW
W00000W
W00M00W
W00000W
W000F0W
WWWWWWW
