WWWWWWW
W00000W
W00M00W
W0P000M
W000F0W
WWWWWWW
