WWWWWWW
W00000W
W00M00W
W0P0M0W
W000F0W
WWWWWWW
