WWWWWWW
W00000W
W00MM0W
W0P000W
W000F0W
WWWWWWW
