WWWWWWW
W00000W
W00M00W
W0P000W
W00FF0W
WWWWWWW
