WWWWWWW
W00000W
W00M00W
W0F000W
W000F0W
WWWWWWW
